■■■■■ ■ ■■■■■ ■ ■■■■■
■···· — ····· — ····■
■■■■■ ■ ■■■■■ ■ ■■■■■
■ |       |       | ■
■■■■■   ■■■■■   ■■■■■
■···■   ■···■ — ■···■
■■■■■   ■■■■■   ■···■
■         |     ■···■
■■■■■   ■■■■■   ■···■
■···■   ■·≡·■   ■···■
■■■■■ ■ ■►═◄■ ■ ■■■■■

■■■■■ ■ ■■■■■ ■ ■■■■■
■···■   ■·≡·■   ■···■
■···■   ■■■■■   ■■■■■
■···■     |       | ■
■···■   ■■■■■   ■■■■■
■···■ — ■···■ — ■···■
■■■■■   ■■■■■   ■···■
■ |       |     ■···■
■■■■■   ■■■■■   ■···■
■···■   ■·≡·■   ■···■
■■■■■ ■ ■■■■■ ■ ■■■■■

■■■■■ ■ ■►═◄■ ■ ■■■■■
■···■   ■·≡·■   ■···■
■■■■■   ■■■■■   ■■■■■
■ |       |       | ■
■■■■■   ■■■■■   ■■■■■
■···■ — ■···■ — ■···■
■···■   ■■■■■   ■···■
■···■     |     ■···■
■···■   ■■■■■   ■···■
■···■   ■···■   ■···■
■■■■■ ■ ■■■■■ ■ ■■■■■

■                   ■
■                   ■
■                   ■
■         |         ■
■■■■■   ■►═◄■   ■■■■■
■···  —  ···  —  ···■
■■■■■   ■►═◄■   ■■■■■
■         |         ■
■                   ■
■                   ■
■                   ■

.